"999999999HIGH SCORE999999999",
"999999999ssssssssss999999999",
"9999999999999999999999999999",
"1111111111111111111111111111",
"1222222222222112222222222221",
"1211112111112112111112111121",
"1311112111112112111112111131",
"1211112111112112111112111121",
"1222222222222222222222222221",
"1211112112111111112112111121",
"1211112112111111112112111121",
"1222222110000110000112222221",
"1111112111110110111112111111",
"9999912111110110111112199999",
"9999912110000gg0000112199999",
"9999912110111111110112199999",
"1111112110188888810112111111",
"w0000020001gggggg1000200000w",
"1111112110188888810112111111",
"9999912110111111110112199999",
"9999912110000000000112199999",
"9999912110111111110112199999",
"1111112110111111110112111111",
"1222222222222112222222222221",
"1211112111112112111112111121",
"1211112111112112111112111121",
"1322112222222pp2222222112231",
"1112112112111111112112112111",
"1112112112111111112112112111",
"1222222112222112222112222221",
"1211111111112112111111111121",
"1211111111112112111111111121",
"1222222222222222222222222221",
"1111111111111111111111111111",
"99rrrrrrrr999999999999999999",
"99rrrrrrrr999999999999999999"